{
    "Stage-3": {
        "0": 0,
        "1": 0,
        "10": 3,
        "100": 0,
        "101": 0,
        "102": 0,
        "103": 0,
        "104": 0,
        "105": 0,
        "106": 0,
        "107": 0,
        "108": 0,
        "109": 0,
        "11": 0,
        "110": 0,
        "111": 0,
        "112": 0,
        "113": 0,
        "114": 3,
        "115": 2,
        "116": 0,
        "117": 3,
        "118": 0,
        "119": 0,
        "12": 0,
        "120": 3,
        "121": 3,
        "122": 3,
        "123": 3,
        "124": 3,
        "13": 0,
        "14": 0,
        "15": 0,
        "16": 0,
        "17": 0,
        "18": 2,
        "19": 0,
        "2": 0,
        "20": 3,
        "21": 3,
        "22": 3,
        "23": 3,
        "24": 3,
        "25": 0,
        "26": 0,
        "27": 0,
        "28": 0,
        "29": 0,
        "3": 0,
        "30": 0,
        "31": 0,
        "32": 0,
        "33": 0,
        "34": 0,
        "35": 0,
        "36": 0,
        "37": 0,
        "38": 0,
        "39": 0,
        "4": 0,
        "40": 1,
        "41": 0,
        "42": 0,
        "43": 0,
        "44": 3,
        "45": 3,
        "46": 3,
        "47": 3,
        "48": 3,
        "49": 3,
        "5": 0,
        "50": 0,
        "51": 0,
        "52": 0,
        "53": 0,
        "54": 0,
        "55": 0,
        "56": 0,
        "57": 0,
        "58": 0,
        "59": 0,
        "6": 0,
        "60": 0,
        "61": 0,
        "62": 0,
        "63": 0,
        "64": 0,
        "65": 0,
        "66": 0,
        "67": 0,
        "68": 0,
        "69": 0,
        "7": 0,
        "70": 3,
        "71": 3,
        "72": 3,
        "73": 3,
        "74": 3,
        "75": 0,
        "76": 0,
        "77": 0,
        "78": 0,
        "79": 0,
        "8": 0,
        "80": 0,
        "81": 0,
        "82": 0,
        "83": 0,
        "84": 0,
        "85": 0,
        "86": 0,
        "87": 0,
        "88": 0,
        "89": 0,
        "9": 0,
        "90": 0,
        "91": 0,
        "92": 0,
        "93": 0,
        "94": 0,
        "95": 3,
        "96": 3,
        "97": 3,
        "98": 3,
        "99": 3,
        "StageSize": [
            5.0,
            5.0,
            5.0
        ]
    }
}
